###############################
### H  ###        ###     M  ##
##   ###    ###   ###    ##   #
# w ###   h  ###   ###   ##   #
#  ###     ###    ###   ##   ##
#       x ###     p    ### G###
###############################