###############################
#H w##        M        #      #
###     ################      #
#   ##         p M     #   G  #
###  h  ################      #
#   ##             M x #      #
###############################