###############################
#H      w     ##       M     G#
# #####   ##################  #
# h    p    ###  x    ####  ###
###   ###          ####     ###
###         ###    M       ####
###############################